1111111111111111111111111
1E0000000C00000100000C001
111101011110100C000000101
10101011C1011111100010101
1P00000000C1000C0001000C1
1001000000000010100100001
1111111111111111111111111
